NO ./textures/blue.xpm
SO ./textures/brick.xpm
WE ./textures/grey.xpm
EA ./textures/wood.xpm
D ./textures/door.xpm
d ./textures/open_door.xpm

F 0,136,0
C 0,255,255

        1111111111111111111111111
        1000000000110000000000001
        1011000001110000000000001
        10010000000D0000000000001
111111111011000001110000000000001
100000000011000001110111111111111
11110111111111D11100000010001
11110111111111011101010010001
11000000110101011100000010001
10000000000000N01100000010001
100000000000000011D1010010001
1100000111010101110101111000111
11110111 1110101 101111010001
11111111 1111111 111111111111